5 5
# S # # #
# . . . #
# . # . #
# . . . #
# # # G #
